1111111111111111111111111111111111111111111111111111111111111111
1111111111111111111111111111111111111111111111111111111111111111
1000000000000000000000000000000000010000000000000000000000000001
1000000000000000000000000000000000010000000000000000000000000001
1000000000000000000000000000000000010000000000000000000000000001
1000000000000000000000000000000000010000000000000000000000000001
1000000000000000000000000000000000010000000000000000000000000001
1000000000000000000000000000000000010000000000000000000000000001
1000000000000000011111110000000011110000000000000000000000000001
1000000000000000010000010000000000010000000000000000000000000001
1000000000000000010000010000000000010000000000000000000000000001
1000000000000111110000010000000000010000000000000000000000000001
1000000000000000010000010000000111110000000000000000000000000001
1000000000000000010000010000000000010000000000000000000000000001
1000000000000000010000010000000000010000000000000000000000000001
1000000000000000010000010000000000010000000000000000000000000001
1011111100000000010000010000001111110000000000000000000000000001
1000000000000000000000010000000000010000000000000000000000000001
1000000000000000000000010000000000010000000000000000000000000001
1000000000000000000000010000000000010000000000000000000000000001
1000000000000111111110010000011111110000000000000000000000000001
1000000000000000000000010000000000010000000000000000000000000001
1000000000000000000000010000000000010000000000000000000000000001
1002000000000000000000010000000000010000000000000000000000000001
1111111111111111111111111111111111111111111111111111111111111111
1111111111111111111111111111111111111111111111111111111111111111
1111111111111111111111111111111111111111111111111111111111111111
1111111111111111111111111111111111111111111111111111111111111111
