3555555555555555555555555555555555555555555555555555555555555553
3000000000000000000000000000000000000000000000000000000000000003
3000000000000000000000000000000000000000000000000000000000000003
3000000000000000000000000000000000000000000000000000000000000003
3000000000000000000000000000000000000000000000000000000000000003
3000000000000000000000000000000000000000000000000000000000000003
3000000000000000000000000000000000000000000000000000000000000003
3000000000111110111110100010100010000000000000000000000000000003
3000000000100000001000110010110010000000000000000000000000000003
3000000000111000001000101010101010000000000000000000000000000003
3000000000100000001000100110100110000000000000000000000000000003
3000000000100000111110100010100010000000000000000000000000000003
3000000000000000000000000000000000000000000000000000000000000003
3000000000000000000000000000000000000000000000000000000000000003
3000000000000000000000000000000000000000000000000000000000000003
3000000000000000000000000000000000000000000000000000000000000003
3000000000000000000000000000000000000000000000000000000000000003
3000000000000000000000000000000000000000000000000000000000000003
3000000000000000000000000000000000000000000000000000000000000003
3000000000000000000000000000000000000000000000000000000000000003
3000000000000000000000000000000000000000000000000000000000000003
3000000000000000000000000000000000000000000000000000000000000003
3000000000000000000000000000000000000000000000000000000000000003
3000000000000000000000000000000000000000000000000000000000000003
3000000200000000000000000000000000000000000000000000000000000003
3555555555555555555555555555555555555555555555555555555555555553